			NO ./textures/bluestone.xpm              	
	SO ./textures/colorstone.xpm		
  	WE ./textures/greystone.xpm                      
		EA			 ./textures/mossy.xpm




		
	F 220		,100,0
			C 225,30,0
1111111
10000001  011111
10000001   100001    
10000001  011001
100000001111100011111
100000000000000000001
100000000000000000001         1
1000000000000000000001       101
 1000000001110000000001     10001
  1000000000000000000001 111000001
   10000000000100000001 100000001
    1000000000000000000110000010011111
    1000000000011110000000000N00000000
0011
    10000000001   10000111000000000011
    1000000001     1111111000000001111
    111111111             100000011
                           1111011
                             101
                              111
                              11
1111111111111111111
1000000000000000001
1111111111111111101
