
	NO ./textures/bluestone.xpm              	
	SO ./textures/colorstone.xpm		
  	WE ./textures/greystone.xpm                      
		EA			 ./textures/mossy.xpm


F 50,50,50
C 0,100,255

11111111111111111
100000000000000001
10000001111111111
100N00000001
111111111111

