NO ./textures/bluestone.xpm
SO ./textures/colorstone.xpm
WE ./textures/mossy.xpm
EA ./textures/greystone.xpm




		
F 220,100,0
C 225,0,255

111111111111111111111111111111111111
100000000000020000000000000000000011
100000000000000001111111111111110111111
11000020000000N000000111111111100000021
1111111111111111001111111111111111111111
1000000000000000000000000000000000000001
10000000020000000000000000002000000000021
11111111111111111000000000000000000211111
11111111111111111111111111111111111111111